ar	ara
ben	in(ben)
bs	ba
cs	rs
cz_qwerty	cz(qwerty)
dev	in(deva)
dvorak	us(dvorak)
dzdwi	bt
el	gr
en_US	latin
guj	in(guj)
gur	in(guru)
iu	ca(ike)
lo	la
kan	in(kan)
mi	mao
ogham	ie(ogam)
ori	in(ori)
sapmi	no(smi)
syr	sy(syc)
tel	in(tel)
tml	in(tam)
fr-latin9	fr(latin9)
us_intl	us(alt-intl)
